================================
=.....................=........=
=.....................=........=
=.....................=........=
=.....................=........=
=.....................=........=
=.....................=........=
=.....................=........=
=.....................=........=
=.....................==========
=.....................=........=
=.....................=........=
=.....................=........=
=.....................=........=
=.....................=........=
=.....................==========
=.....................=........=
=.....................=........=
=.....................=........=
=.....................=........=
=.....................=........=
=.....................=........=
=.....................=........=
=.....................=........=
================================
=..............................=
=..............................=
=..............................=
=..............................=
================================
