............1111
.1111.......1111
.1111.......1111
............1111
................
....111.........
.....1..........
....111.........
................
................
........1.......
................
................
..111.....1.....
................
